##########
#& #     #
#  #     #
#X #     #
#      X@#
##########
